#######################################################
#P   ##      #                    ##              #   #
# ##### # ## ##### ##### ## ##### ## # #  # ##### # # #
#     # # #        #     ##     #     ##### #####   # #
# ### # # ###### ####### ##### ###### ##     ######## #
###   # #      #     ##     #        ### ###     ##*  #
# # ### ###### ### ### ### #### #*### ## *##### ##### #
#    #   #         #     #       #    # ### ### #   # #
# #     ##   ### ### ### ######## ### # ###   #   # # #
### ########       #########       #  # ##### #  ## ###
#       #########  #       ######     #    ## # ### ###
#   #     ##       #   ##        ## #E###  #   ##   * #
# ### ###  ## ###### ### # ########## ##### ####   ## #
#   #*      #  *##      #          #             #   *#
#######################################################

